##########
#.......@#
#........#
#........#
#........#
#........#
#........#
##########