##########
#.......@#
#.######.#
#.##...#.#
#.#..#...#
#.######.#
#........#
##########